BP	BAIE ST PAUL	Parish of BAIE ST PAUL
BE	BIG EDDY	Parish of BIG EDDY
BH	BROKENHEAD	BROKENHEAD Indian Reserve
CR	CROSS LAKE	CROSS LAKE Settlement
DN	DUCK BAY NORTH	DUCK BAY NORTH Settlement
DS	DUCK BAY SOUTH	DUCK BAY SOUTH Settlement
FF	FAIRFORD	FAIRFORD Settlement
FM	FAIRFORD MISSION	Parish of FAIRFORD MISSION
FB	FISHER BAY	Parish of FISHER BAY
FA	FORT ALEXANDER	FORT ALEXANDER Settlement
GR	GRAND RAPID	GRAND RAPID Settlement
GP	GRANDE POINTE	Parish of GRANDE POINTE
HE	HEADINGLY	Parish of HEADINGLY
HB	HIGH BLUFF	Parish of HIGH BLUFF
KI	KILDONAN	Parish of KILDONAN
LO	LORETTE	Parish of LORETTE
MR	MANIGOTAGAN RIVER	MANIGOTAGAN RIVER Settlement
MH	MANITOBA HOUSE	MANITOBA HOUSE Settlement
OI	OAK ISLAND	OAK ISLAND Settlement
OP	OAK POINT	OAK POINT Settlement
PQ	PASQUIA	PASQUIA Settlement
PC	PINE CREEK	PINE CREEK Settlement
PO	POPLAR POINT	Parish of POPLAR POINT
PP	PORTAGE LA PRAIRIE	Parish of PORTAGE LA PRAIRIE
RR	RAT RIVER	RAT RIVER Settlement
RM	RIDING MTN NATIONAL PARK	RIDING MOUNTAIN NATIONAL PARK
RC	ROMAN CATHOLIC MISSION PROPERTY

Y	ROMAN CATHOLIC MISSION PROPERTY Settlement
AD	ST ANDREWS	Parish of ST ANDREWS
BO	ST BONIFACE	Parish of ST BONIFACE
CH	ST CHARLES	Parish of ST CHARLES
CL	ST CLEMENTS	Parish of ST CLEMENTS
FX	ST FRANCOIS XAVIER	Parish of ST FRANCOIS XAVIER
JA	ST JAMES	Parish of ST JAMES
JO	ST JOHN	Parish of ST JOHN
LA	ST LAURENT	Parish of ST LAURENT
MA	ST MALO	Parish of ST MALO
NO	ST NORBERT	Parish of ST NORBERT
PA	ST PAUL	Parish of ST PAUL
PE	ST PETER	Parish of ST PETER
VI	ST VITAL	Parish of ST VITAL
AG	STE AGATHE	Parish of STE AGATHE
AN	STE ANNE	Parish of STE ANNE
PS	THE PAS	THE PAS Settlement
UV	UMFREVILLE	UMFREVILLE Settlement
WE	WESTBOURNE	WESTBOURNE Settlement
NH	NORWAY HOUSE	NORWAY HOUSE Settlement
